1 3 4744 3891 8783 
1 5 8783 8731 3939 8641 3569 
1 8 8615 8650 8608 8609 158 8661 912 8531 
1 3 8531 912 8661 
1 3 1901 9047 9011 
1 2 8289 8262 
1 2 2012 4112 
1 3 4996 7698 7669 
1 3 7669 895 3122 
1 7 1896 7388 9 7382 2052 630 7408 
1 4 673 1896 7424 7450 
1 2 3134 7309 
1 2 7260 7302 
1 3 7302 7339 4354 
1 3 7183 7196 4569 
1 3 4569 4369 7137 
1 6 4842 4533 2239 3213 3311 3993 
1 4 964 1597 4292 4842 
1 5 6940 349 3817 4520 3213 
1 5 7476 7460 2906 7482 7467 
1 4 7476 4617 4400 7582 
1 4 192 3136 717 1129 
1 5 7476 1150 3488 4709 7340 
1 5 7340 7343 7326 7313 7330 
1 3 7340 4000 3748 
1 4 3748 7374 966 7315 
1 4 2790 5380 5354 5347 
1 2 1159 6491 
1 9 1159 6438 6412 1591 1803 1479 2435 6149 6070 
1 5 6117 1260 2517 1509 1803 
1 5 5692 5718 1202 3755 1694 
1 3 1694 3755 494 
1 4 6070 237 390 6364 
1 8 6521 6520 1309 2686 2351 6453 178 6364 
1 3 7374 3092 2644 
1 3 2644 1054 4725 
2 4 5625 5103 4759 4146 
2 5 4146 5699 520 1265 5864 
2 4 5864 4665 1516 3706 
1 6 2083 1774 1740 5912 1584 4665 
1 4 6085 1786 4818 5912 
1 6 5971 5957 758 5914 5910 2083 
1 6 4283 5563 2537 5587 5571 5520 
1 6 5520 5483 2291 5405 5374 5352 
1 3 5520 2970 1488 
1 4 2789 4025 5610 5587 
1 4 1488 4113 3394 2106 
1 8 4433 1695 3894 3618 5773 4497 5716 2789 
1 6 2083 3014 1375 5847 1139 2932 
1 4 2932 5740 5695 1488 
2 6 5719 5711 2752 5705 5688 4146 
1 3 7340 7316 1168 
1 3 1694 4252 5541 
1 4 1694 4252 5512 3171 
1 5 5545 570 936 868 655 
1 3 2343 3550 5376 
1 4 5545 570 4505 4640 
1 5 5411 5443 360 5489 5518 
1 3 5518 704 5451 
1 6 5518 1839 5557 1455 3654 5567 
1 5 5567 5578 5568 5005 5573 
1 6 4541 1098 1134 5766 5791 2429 
1 3 2513 5785 1134 
1 3 5629 195 1041 
1 2 5332 1853 
2 8 1041 1935 182 5724 5759 1858 5795 636 
1 5 1041 4786 385 3430 5547 
1 6 5547 1747 2096 623 5393 5361 
1 7 5361 5327 4389 5304 5294 3399 5284 
1 9 5547 5535 5510 4674 5515 5019 5503 2576 5514 
1 6 2905 5631 2974 2224 1762 5518 
2 5 636 2063 260 5793 1286 
1 6 1286 5754 1598 733 2592 5514 
1 6 5514 1099 4829 5470 3350 4639 
1 5 1286 1225 1349 19 5547 
1 7 2429 5825 4897 5821 3274 5851 5860 
1 4 5573 5609 42 2787 
1 8 5518 1839 5557 5056 5633 4043 2553 5755 
1 5 6091 71 4689 6209 6251 
1 5 6251 2721 6324 6401 4161 
1 4 6251 3928 2324 6238 
1 6 1092 5564 3600 176 5637 5656 
1 3 5860 3255 2513 
1 5 4541 5673 752 5605 5567 
1 5 2513 1835 42 5609 5573 
1 5 5376 5402 5433 1447 4076 
1 9 5376 5402 5433 1975 3091 5521 5549 5586 5620 
1 5 5376 3428 5435 5460 4850 
1 7 5620 3837 411 1889 2753 1513 5854 
1 5 5854 5846 313 3714 3187 
1 4 3187 5808 5771 4110 
1 6 5854 5836 5833 4134 2925 5860 
1 5 5860 5879 2213 2834 5075 
1 5 5620 5606 5624 5616 2787 
1 8 4110 618 68 1014 5581 2216 5517 4850 
1 2 5854 5885 
1 7 4110 618 3147 5617 5612 2870 5620 
1 2 4076 5421 
1 7 8016 8031 4962 839 8007 7971 8001 
1 7 8001 1594 4801 8103 3107 4430 8049 
1 3 8214 5114 8103 
1 2 8124 4801 
1 2 7132 7147 
1 2 8400 2915 
1 5 2915 8439 8485 4847 759 
1 3 3122 809 1527 
1 2 809 7450 
1 2 7309 9 
1 5 925 3145 6156 543 6124 
1 7 925 6189 823 2158 2205 4900 4311 
1 3 2205 6132 6115 
1 4 4311 6019 6009 5075 
2 8 925 6219 6236 6237 6233 440 1180 6296 
1 6 6124 270 6074 3735 3542 6022 
1 6 6022 5996 5966 2165 4932 5827 
1 8 5075 4290 1443 5909 965 2726 3777 5827 
1 6 2963 5400 5422 4652 323 1092 
1 4 1092 234 1514 3501 
1 4 1092 2740 1183 1324 
1 5 1324 1790 1467 5484 4516 
1 2 9164 1448 
1 3 9233 9231 1448 
1 5 9233 3226 3042 9257 9258 
1 4 9258 3351 9217 3719 
1 3 3719 1149 1337 
1 6 1337 9061 9029 4125 8900 1044 
1 3 4608 9042 9075 
1 4 9075 9094 2235 9164 
1 6 4855 8763 4442 8837 4270 8900 
1 3 1717 9326 9347 
1 6 1717 576 4977 9237 346 1711 
1 5 9279 4355 3691 9341 9347 
1 2 4412 9400 
1 4 9340 9375 9386 9400 
1 5 3022 9134 9109 4594 2046 
1 5 9279 3257 9273 517 9258 
1 4 4112 8318 5121 8262 
1 4 8958 4793 1283 8934 
1 2 9011 1283 
1 2 4452 631 
1 3 8531 8483 8433 
1 6 1646 811 8642 8590 8631 759 
1 2 4956 1646 
1 3 8049 4620 5010 
1 5 4467 1503 3746 4456 3108 
1 4 7072 1278 7138 4948 
1 4 4948 7173 7156 7147 
1 3 7349 509 673 
1 4 8934 8963 8999 4608 
1 6 8661 8672 4257 8806 2637 4855 
1 4 1044 452 8846 4956 
1 2 8697 4051 
1 6 4051 8718 8646 4335 8524 4930 
1 2 4930 836 
1 6 8697 3887 4589 3483 4504 3335 
1 5 8289 5060 8200 8123 8124 
1 7 2939 2508 3901 4119 2094 3088 7660 
1 3 7660 2690 4456 
1 3 3108 3260 4725 
1 5 5576 2206 3362 2826 3451 
1 4 3451 5691 1365 3440 
1 6 3451 2826 5660 5619 438 5594 
1 4 5594 5575 5562 1220 
1 4 1220 5529 3508 4132 
1 4 4132 2433 4047 5325 
1 6 4132 4858 3101 5533 5555 1528 
1 2 1528 4516 
1 2 3451 2285 
1 6 271 5154 5157 5165 3809 5195 
1 4 5195 2146 5216 5230 
1 3 5230 5224 5231 
1 9 5231 2439 3017 5205 5206 4013 2654 5201 3581 
1 7 2697 45 5283 5286 5287 2333 4286 
1 6 5230 4551 5252 5263 3310 4286 
1 8 5168 4546 3125 5180 5184 5183 3809 5195 
1 4 5160 5165 3809 5195 
1 5 3581 4133 5210 5218 3814 
1 2 7132 3244 
1 3 3244 7052 3213 
1 4 7137 1468 3993 3311 
1 3 2620 1372 7241 
1 4 8049 5102 3036 2939 
1 7 3922 7949 8021 7979 2830 3221 8044 
1 6 7763 682 7688 1932 7616 7602 
1 2 4435 7467 
1 3 1168 1520 4948 
1 4 7073 6965 6866 1025 
1 4 6866 2357 2827 122 
1 4 122 906 4604 620 
1 4 964 1978 6958 4604 
1 4 7072 7053 7022 964 
1 11 8400 3130 8356 8316 8270 8171 8128 1589 8083 5010 4620 
1 8 2915 1958 4833 8208 8164 8111 3557 8021 
1 13 4930 8509 131 8508 2503 8516 141 3415 8555 8663 4585 8758 1646 
1 3 4908 8917 1519 
1 3 1519 4598 8758 
1 3 3957 3283 1519 
1 4 2046 9026 9000 3957 
1 6 4908 8943 2030 8987 1010 4278 
1 4 7274 7265 3328 4073 
1 3 4073 3629 7214 
1 10 6906 4323 5098 6878 2398 5025 6845 5122 6832 4274 
1 2 6732 3035 
1 3 3035 6705 3653 
1 2 3780 6705 
1 6 3653 6701 3344 6739 184 4274 
1 4 3640 2412 3728 6906 
1 7 7214 1218 7141 3072 2027 2807 3640 
1 3 3882 1775 6994 
1 4 3640 1614 842 3882 
1 5 6994 2938 827 4553 4369 
1 5 7315 1873 7307 2528 3390 
1 4 3390 872 1129 7073 
1 3 4464 4056 434 
1 4 434 1780 8209 8252 
1 3 8252 3216 3335 
1 7 514 7980 8003 8057 8096 1791 8125 
1 5 8125 123 8159 4694 8252 
1 4 514 7997 1670 8032 
1 4 6734 1949 6743 3585 
1 6 6855 2329 1697 6773 971 6734 
1 7 6788 345 3489 1056 4747 2334 6734 
1 3 6521 2583 6583 
1 6 6583 1625 4233 173 6720 6734 
1 3 6589 2341 4233 
1 3 2938 6945 6923 
1 4 6923 6900 6875 6855 
1 2 6940 6900 
1 2 4598 4585 
1 5 6807 502 6893 6911 4842 
1 6 6855 3943 6828 1704 1499 6788 
1 4 6788 2189 2263 6807 
1 4 6626 6653 1612 6739 
1 3 6626 213 990 
1 4 990 6507 1799 6364 
1 6 4274 4251 3175 1865 2771 3585 
1 3 6807 2585 1172 
1 3 1172 2574 122 
1 4 3134 7275 2692 1962 
1 3 1962 7116 3072 
1 3 1892 4308 7260 
1 2 1136 2341 
1 3 192 783 3185 
1 4 4159 7446 89 4677 
1 4 4677 7436 7452 7433 
1 4 7433 7410 4949 7381 
1 6 7381 7398 7411 2454 118 7447 
1 5 4159 805 425 2756 4975 
1 3 4975 1452 7097 
1 4 4975 1017 115 3185 
1 3 2120 7939 514 
1 6 2120 7845 2832 7807 7817 4740 
1 5 2120 7824 3193 7738 1145 
1 5 1145 3549 7639 7658 7630 
1 5 7630 1217 7524 4009 7447 
1 5 1145 3881 7596 7561 3452 
1 5 4740 2662 1957 7711 3724 
1 2 3724 7661 
1 3 7661 2782 377 
1 5 377 5133 743 2596 4464 
1 7 2939 2508 7737 2999 3326 3409 4285 
1 3 4285 7543 1176 
1 5 1176 4366 2926 1926 192 
1 8 836 26 1879 8194 205 8149 4056 4464 
1 11 4278 5120 1608 5066 4544 8910 8870 8830 8817 8759 4051 
1 8 8910 962 4028 8765 8734 110 2750 8516 
1 4 3415 8448 4325 511 
1 7 511 1909 1859 610 8220 8233 8208 
1 3 1608 2251 2541 
1 3 451 2880 4852 
1 7 4852 4061 9129 4470 3435 3188 9262 
1 3 9262 2098 5001 
1 7 5001 4951 563 9309 9335 3285 3522 
1 4 1007 3644 1314 9262 
1 4 9129 676 9090 4780 
1 3 9428 4358 4910 
1 7 9453 9457 9450 9439 9431 2992 9428 
1 5 4910 3794 9402 9384 3522 
1 6 4476 9468 2080 9458 2394 9453 
1 3 9488 9483 9479 
1 3 9479 4075 9472 
1 4 2394 9442 4688 9423 
1 3 9423 9414 3912 
1 7 2453 9367 9350 1317 2225 9306 1007 
1 5 9422 9412 700 4575 3868 
1 4 9400 3703 9358 3400 
1 4 3400 3388 9351 3995 
1 3 4345 9188 3022 
1 4 4608 9024 3484 9025 
1 3 8934 8875 505 
1 2 3912 2453 
1 2 6022 6030 
2 4 6671 3895 988 4304 
2 11 6671 690 551 80 6779 4413 4492 2382 6894 3010 3414 
2 6 3414 6959 2990 101 2177 7187 
2 6 7166 4288 7112 7088 1470 2990 
1 3 1701 2792 80 
1 4 2543 6816 4706 4413 
1 4 2413 485 1269 6959 
1 4 2413 958 488 6666 
1 2 249 958 
1 4 6962 6918 6850 2413 
1 2 4258 6918 
2 7 551 2885 6680 5049 4107 3001 6557 
